Data;Descricao;Valor;Saldo
10/09/24 às 12:07:46;Pagamento para BANCO XP S/A;-R$ 1.866,94;R$ 100,34
10/09/24 às 12:01:10;Pix recebido de Luiz Henrique Normando Sousa;R$ 200,00;R$ 1.967,28
10/09/24 às 11:59:42;Pix recebido de Luiz Henrique Normando Sousa;R$ 1.700,00;R$ 1.767,28
12/08/24 às 09:05:05;Pagamento para BANCO XP S/A;-R$ 1.343,77;R$ 67,28
09/08/24 às 20:18:01;Pix recebido de Luiz Henrique Normando Sousa;R$ 1.400,00;R$ 1.411,05
16/07/24 às 10:41:19;Campanha Pix XP recebido de Banco Xp S.A;R$ 0,01;R$ 11,05
15/07/24 às 08:16:33;Pagamento para BANCO XP S/A;-R$ 2.098,23;R$ 11,04
10/07/24 às 11:34:17;Pix recebido de Luiz Henrique Normando Sousa;R$ 2.100,00;R$ 2.109,27
